NO ./sprites/NORTH.xpm
WE ./sprites/WEST.xpm
SO ./sprites/SOUTH.xpm
EA ./sprites/EAST.xpm

C 111, 168, 220
F 53, 150, 11

        1111111111111111111111111
        1000000000110000000000001
        1011000001110000000000001
        1001000000000000000000001
111111111011000001110000000000001
100000000011000001110111111111111
11110111111111011100000010001
11110111111111011101010000001
11000000110101011100000010001
10000000000000001100000010001
100000000000000011010100111111
110000011101010111110111111001
111101111111011111110111100101
10000001 1000001 1010000000N01
11111111 1111111 1111111100001
                        111111