NO ./path_to_the_north_texture
WE ./path_to_the_west_texture
SO ./path_to_the_south_texture
EA ./path_to_the_east_texture

C 70,0,255 
F 50,205,50

        1111111111111111111111111
        1000000000110000000000001
        1011000001110000000000001
        1001000000000000000000001
111111111011000001110000000000001
100000000011000001110111111111111
11110111111111011100000010001
11110111111111011101010010001
11000000110101011100000010001
10000000000000001100000010001
100000000000000011010100111111
110000011101010111110111111001
111111111111111111111111100001
11110111 1110101 1011110100N01
11111111 1111111 1111111100001
                        111111