NO ./sprites/NORTH.xpm
WE ./sprites/WEST.xpm
SO ./sprites/SOUTH.xpm
EA ./sprites/EAST.xpm


        1111111111111111111111111
        1000000000110000000000001
        1011000001110000000100001
        1001000000000000000000001
111111111011000001110000000000001
100000000011000001110111111111111
111111111111111111110111111111
111101111111110111000000100011
111101111111110111010100000011
110000001101010111000000100011
100000000000000011000000100011
100000000000000011010100111111
110000011101010111110111111001
111101111111011111110111100101
10000001 1000001 1010000000N01
11111111 1111111 1111111100001

C 111,168,220
F 53,150,11
11111111 1111111 1111111111111